KOTLINE SA KLISURAMA
VRANJSKA KOT.			GOLUBAČKA KLISURA
BRESTOVAČKA KOT.		KLISURA KAZAN
LJUPKOVSKA KOT.			GRDELIČKA KLISURA
NIŠKA KOT.			SIPSKA KLISURA
MEZGRAJSKO SUŽENJE		VLAŠKO-PONTIJSKA NIZIJA
LESKOVAČKA KOT.			KLISURA GOSPOĐA VIR
ORSAVSKA KOT.			KURVINGRADSKO SUŽNJE 
PEČENJEVAČKO SUŽENJE		DONJOMILANOVAČKA KLISURA

RODBINSKE VEZE
SNAJA				BRATOVA ŽENA
JETRVA				ŽENA MUŽEVLJEVOG BRATA
ZAOVA				MUŽEVLJEVA SESTRA
SVASTIKA			ŽENINA SESTRA
ŠURNJAJA			ŽENA ŽENINOG BRATA
SVEKRVA				MUŽEVLJEVA MAJKA
TAŠTA				ŽENINA MAJKA
PRIJA				MAJKA ĆERKINOG MUŽA
STRINA				ŽENA OČEVOG BRATA
UJNA				ŽENA MAJČINOG BRATA

SPOJITE PRAVA IMENA GLUMACA SA NADIMNKOM
MIĆA ORLOVIĆ			MILOJE
MIĆA TATIĆ			MILUTIN
MIJA ALEKSIĆ			MIROSLAV
MIĆA TOMIĆ			MILIVOJE
MIKI JEVREMOVIĆ			MIODRAG
MINJA SUBOTA			MILAN
MIŠA BLAM			MIHAILO
MIKA ANTIĆ			MIROSLAV
(ILIĆ) MINIMAKS			MILOVAN
(MANDIĆ) MANDA			MILORAD

SPOJITE PRONALAZAČE SA NJIHOVIM IZUMIMA
INDUKCIONA MAŠINA		NIKOLA TESLA
PENICILI				ALEKSANDAR FLEMING
ELEKTRONSKA POŠTA		REJ TOMLINSON
NUKLEARNI REAKTOR		ENRIKO FERMI
GROMOBRAN			BENDŽAMIN FRENKLIN
ŽIROSKOP			LEON FUKO
TRAKTOR			BENDŽAMIN HOLT
RADIO TALASI			HAJNRIH HERC

POVEŽITE PISCE I DELA
IVO ANDRIĆ			TRAVNIČKA HRONIKA
VIKTOR IGO			JADNICI
LAJOS ZILAHY			KAD DUŠA ZAMRE
MARK TWAIN			AVANTURE HAKLBERI FINA
MEŠA SELIMOVIĆ			TVRĐAVA
MILOŠ CRNJANSKI			SEOBE
ALEKSA ŠANTIĆ			HASANAGINICA
MOMO KAPOR			HRONIKA IZGUBLJENOG GRADA

POVEŽITE LIČNOSTI SA NJIHOVIM OPONENTIMA
NIKOLA TESLA			TOMAS EDISON
HENRI VIII			FRANSOA I
FILIP II				ELIZABETA I
JAŠA TOMIĆ			MIŠA DIMITRIJEVIĆ
NAPOLEON			ALEKSANDAR I
RUZVELT				HIROHITO
MAO CEDUNG			ČANG KAJ ŠEK
ROBERT SKOT			ROALD AMUNDSEN

SPOJITE GRADOVE SA SVOJIM NEKADAŠNJIM NAZIVIMA
BEOGRAD			SINGIDUNUM
SREMSKA MITROVICA		SIRMIJUM
DŽAKARTA			BATAVIJA
KNJAŽEVAC			GURGUSOVAC
JAGODINA			SVETOZAREVO
NJUJORK				NOVI AMSTERDAM
BRATISLAVA			PRESBURG
PODGORICA			TITOGRAD

SPOJITI SRPSKE NAUČNIKE SA MESTOM ROĐENJA
RUĐER BOŠKOVIĆ			DUBROVNIK
NIKOLA TESLA			SMILJAN
MIHAJLO PUPIN			IDVOR
MILUTIN MILANKOVIĆ		DALJ
JOSIF PANČIĆ			UGRINI
JOVAN CVIJIĆ			LOZNICA
PAVLE SAVIĆ			SOLUN
SLOBODAN RIBNIKAR		BEOGRAD

SPOJITI FILMOVE I SERIJE SA NJIHOVIM SCENARISTIMA
URNEBESNA TRAGEDIJA		DUŠAN KOVAČEVIĆ
BOLJE OD BEKSTVA		SINIŠA KOVAČEVIĆ
MI NISMO ANĐELI			SRĐAN DRAGOJEVIĆ
MEHANIZAM			GORDAN MIHIĆ
NACIONALNA KLASA		GORAN MARKOVIĆ
BOLJI ŽIVOT			SINIŠA PAVIĆ
BUMERANG			SVETISLAV BASARA
SIVI KAMION CRVENE BOJE		SRĐAN KOLJEVIĆ

SPOJITE LIKOVE IZ CRTANIH FILMOVA SA ŽIVOTINJOM KOJU PREDSTAVLJAJU
SILVESTER			MAČAK
MLATA				PAS
BAJA				PATAK
DŽERI				MIŠ
MANFRED			MAMUT
MARTI				ZEBRA
GLORIJA				NILSKI KONJ
MAJOR				PINGVIN

SPOJITE POZNATA PIĆA SA DRŽAVAMA
GINIS				IRSKA
APSINT				ČEŠKA
LOZOVAČA			CRNA GORA
BURGUNDAC			FRANCUSKA
TEKILA				MEKSIKO
RAKI				TURSKA
METAKSA			GRČKA
KAPIROSKA			BRAZIL

SPOJITI SRPSKE VOJSKOVODE SA MESTOM ROĐENJA
HAJDUK VELJKO			LENOVAC
STANOJE GLAVAŠ			GLIBOVAC
VUK ISAKOVIĆ			SREDSKA
KARAĐORĐE PETROVIĆ		VIŠEVAC
STOJAN ČUPIĆ			PIVA
VASA ČARAPIĆ			BELI POTOK
LAZAR HREBALJANOVIĆ		PRILEPAC
PETAR DOBRNJAC			DOBRINJE

POVEŽITE SKRAĆENICE SA POJMOVIMA KOJE OZNAČAVAJU
DC				JEDNOSMERNA STRUJA
GPS				NAVIGACIONI SISTEM
HTML				OPISNI JEZIK ZA WEB STRANICE
ISO				STANDARD
JPEG				FORMAT ZA SLIKE
PHP				SKRIPTNI JEZIK
DIN				FABRIKA DUVANA
NIN				INFORMATIVNE NOVINE

SPOJITE SVECE SA MANASTIRIMA U KOJIMA LEŽE NJIHOVE MOŠTI
STEFAN NEMANJA			STUDENICA
VASILIJE OSTROŠKI			GORNJI OSTROG
NIKOLAJ VELIMIROVIČ		LELIĆ
SVETA PETKA			JAŠI (RUMUNIJA)
RUKA SV. SAVE			SV. TROJICE (PLJEVLJA)
ILIJA MUROMEC			KIJEVSKO-PEČERSKA LAVRA
SVETI NIKOLA			BARI (ITALIJA)
STEFAN DEČANSKI			VISOKI DEČANI

SPOJITE MATEMATIČARE SA SVOJIM DELIMA
KARL FRIDRIH GAUS		ARITMETIČKA ISTRAŽIVANJA
RIHARD DEDEKIND		PRIRODA I ZNAČENJE BR.
LEONARDO FIBONAČI		KNJ. KVADRATNI BROJEVI
KOLNI MAKLOREN			MOĆ GRAVITACIJE
ŽOZEF FURIJE			ANALITIČKA TEROIJA TOPLOTE
EUKLID				ELEMENTI
DAVID HILBERT			OSNOVE GEOMETRIJE
DANIJEL BERNULI			HIDRODINAMIKA

SPOJITE LIKOVE I GLUMCE IZ SERIJE ,,SLOŽNA BRAĆA"
FIKO				VLADIMIR SAVČIĆ ČOBI
KECMAN				ŽIKA MILENKOVIĆ
SREBRA				NATAŠA NINKOVIĆ
MINER				NELE KARAJLIĆ
NOVINAR CNN-A			DEJAN MATIĆ
URLIKE				SANDRA NOGIĆ
MEMI				DARKO OSTOJIĆ
MUTE				DAVOR DUJMOVIĆ

SPOJITE POZNATA JEZERA SA DRŽAVAMA U KOJIMA SE NALAZE
BALHAŠKO			KAZAHSTAN
VOSTOK				ANTARKTIK
TONLE SAP			KAMBODŽA
LADOGA				RUSIJA
ATABASKA			KANADA
TORENS				AUSTRALIJA
MVERU				KONGO
TURKANA			KENIJA

SPOJITE ZAKONIKE SA DRŽAVAMA
HAMURABIJEV ZAKONIK		MESOPOTAMIJA
CORPUS IURIS CIVILIS		RIM
NOVOBRADSKI ZAKONIK		SRBIJA
MANUOV ZAKONIK		INDIJA
NOMOKANON			VIZANTIJA
VASOJEVIĆKI ZAKONIK		CRNA GORA
ZAKONIK LEKE DUKAĐINIJA		ALBANIJA
ZAKONIK CARA ALEKSEJA		RUSIJA

SPOJITE POZNATE GLUMCE SA FILMOVIMA U KOJIMA SU IGRALI
ENTONI HOPKINS			KAD JAGANJCI UTIHNU
HIT LEDŽER			MRAČNI VITEZ
ROBERT PATRIK			TERMINATOR 2
ŠON BIN				AUTOSTOPER
GARI OLDMEN			PETI ELEMENT
AL PAĆINO			ĐAVOLJI ADVOKAT
ROBERT ENGLUND			STRAVA U UL. BRESTOVA
DENIS HOPER			BRZINA

POVEŽITE PRODATE FABRIKE U SRBIJI SA SVOJIM VLASNICIMA
ZDRAVLJE			PHARMACO HF
DIV				BRITISH AMERICAN TOBACCO
NIS				GAZPROM
BFC BEOČIN			LAFARGE
KNJAZ MILOŠ			SALFORD
ZASTAVA				FIAT
TAKOVO				SWISSLION
DIN				PHILIP MORRIS

POVEŽITE OBOLJENJA SA LATINSKIM NAZIVIMA
ZAPALJENJE DESNI			GINGIVITIS
POVEĆAN KRVNI PRITISAK		HYPERTENSIA
GLAVOBOLJA			CEPHALEA
UVEĆANJE JETRE			HEPATOMEGALIA
ŽELUDČANA KILA			HIATUS HERNIA
ZAPALJENJE PLUĆA		PNEUMONIA
ZAPALJENJE SRČANOG MIŠIĆA	MYIOCARDITIS
ZAPALJENJE KRAJNIKA		TONZILITIS

POVEŽITE REČI SA GLASOVNIM PROMENAMA KOJE SU U NJIMA IZVRŠENE
SNOSITI, SNOŠLJIV			JEDN. PO MJESTU IZGOVORA
SRBIN, SRPSTVO			JEDN. PO ZVUČNOSTI
JUNAK, JUNACI			SIBILARIZACIJA
SAV, SVI				NEPOSTOJANO A
OBLAST, OBLASNI			GUBLJENJE SUGLASNIKA
GRADITI, GRAĐEN			JOTOVANJE
OBOŽAVALAC, OBOŽAVAOCI		PRELAZAK L U O
TOK, TOČITI			PALATALIZACIJA

POVEŽITE REČI SA GLASOVNIM PROMENAMA KOJE SU U NJIMA IZVRŠENE
KUPITI, KUPLJEN			JOTOVANJE
ZELEN, ZELEMBAĆ			JEDN. PO MJESTU IZGOVORA
MRTAV, MRTVA			NEPOSTOJANO A
OLOVKA, OLOVCI			SIBILARIZACIJA
POZORIŠTE, POZORIŠNI		GUBLJENJE SUGLASNIKA
MIO, MILI			PRELAZAK L U O
KAŠIKA, KAŠIČICA			PALATALIZACIJA
KRIŽATI, KRIŠKA			JEDNAČENJE PO ZVUČNOSTI

SPOJITE KNJIŽEVNIKE SA NJIHOVIM DELIMA
P.P. NJEGOŠ			LUČA MIKROKOZMA
PETAR KOČIĆ			JAZAVAC PRED SUDOM
MEŠA SELIMOVIĆ			DERVIŠ I SMRT
BRANKO ĆOPIĆ			ORLOVI RANO LETE
RANKO MARINKOVIĆ		RUKE
MILOŠ CRNJANSKI			ROMAN O LONDONU
DRAGOSLAV MIHAILOVIĆ		PETRIJIN VENAC
VUK DRAŠKOVIĆ			META

POVEŽITE POZNATE LIČNOSTI SA IMENIMA NJIHOVIH KONJA
BANOVIĆ STRAHINJA		ĐOGIN
VOJVODA MOMČILO		JABUČILO
DAMJAN				ZELENKO
ALEKSANDAR MAKEDONSKI		BUKEFAL
VAJAT ERP			DIK HEJLOR
BIK KOJI SEDI			BLEKI
NAPOLEON			MARENGO
SIMON BOLIVAR			PALOMO

SPOJITE MUZIČKE VIRTUOZE SA INSTRUMENTIMA
JOVAN KULUNDŽIJA		VIOLINA
LUIS AMSTRONG			TRUBA
ERIK KLEPTON			GITARA
RINGO STAR			BUBNJEVI
BENI GUDMEN			KLARINET
REJ ČARLS			KLAVIR
MIĆA IVANOVIĆ			HARMONIKA
STEN GEC			SAKSOFON

POVEŽITE GLUMICE SA NJIHOVIM GODINAMA ROĐENJA
ANĐELINA DŽOLI			1975
NIKOL KIDMAN			1967
INGRID BERGMAN			1915
DŽEJN FONDA			1937
MEG RAJAN			1961
MERLIN MONRO			1926
LAJZA MINELI			1946
DŽENIFER GARNER			1972

POVEŽITE KOŠARKAŠE SA KLUBOVIMA U KOJIMA SU STEKLI AFIRMACIJU
MAJKL DŽORDAN			ČIKAGO BULSI
LERI BIRD			BOSTON SELTIKS
DŽULIUS IRVING			FILADELFIJA '76
KARL MELOUN			JUTA DŽEZ
DEJVID ROBINSON			SAN ANTONIO SPARS
KOBI BRAJANT			LOS ANĐELES LEJKERS
HAKIM OLEDŽUON		HJUSTON ROKETS
PATRIK JUING			NJU JORK NIKSI

POVEŽITE KOŠARKAŠE SA KLUBOVIMA U KOJIMA SU STEKLI AFIRMACIJU
MEDŽIK DŽONSON		LOS ANĐELES LEJKERSI
SKOTI PIPEN			ČIKAGO BULSI
TIM DANKAN			SAN ANTONIO SPARS
BIL RASEL			BOSTON SELTIKS
AJZEA TOMAS			DETROIT PISTONS
DŽON STOKON			JUTA DŽEZ
DIRK NOVICKI			DALAS MAVERIKS
GERI PEJTON			SIJETL SUPERONIKS

POVEŽITE NOVINARE SA ZEMLJOM POREKLA
DŽOZEF PULICER			AMERIKA
NAOMI KLAJN			KANADA
TEODOR FONTANE		NEMAČKA
NIKOLAJ ALEKSEJEV		RUSIJA
LJUDOVIT ŠTUR			SLOVAČKA
PETAR JANJATOVIĆ		SRBIJA
VEDRAN RUDAN			HRVATSKA
ROMEO LANGLO			FRANCUSKA

SPOJITE JUNAKE SA BITKAMA
STEVAN SINĐELIĆ			ČEGARSKA BITKA
MILAN TOPLICA			KOSOVSKI BOJ
AHIL				BITKA ZA TROJU
KSERKS I				TERMOPILSKA BITKA
DVAJT AJZENHAUER		ARDENSKA BITKA
ŽIVOJIN MIŠIĆ			KOLUBARSKA BITKA
SAVA KOVAČEVIĆ			BITKA NA SUTJESCI
GEORGIJ ŽUKOV			KURSKA BITKA

SPOJITE ISTORIJSKE LIČNOSTI SA MESTOM NJIHOVE SMRTI
STEVAN SINĐELIĆ			LJUBLJANA
TITO				BERLIN
ALEKSANDAR I KARAĐORĐEVIĆ	ČEGAR
MIHAILO OBRENOVIĆ		KOŠUTNJAK
ADOLF HITLER			RIMSKI SENAT
NAPOLEON BONAPARTA		BOLIVIJA
ČE GEVARA			OSTRVO SVETA JELENA
CEZAR				MARSEJ

POVEŽITE GRAĐEVINE SA ZEMLJAMA U KOJIMA SE NALAZE
KINKAKU-ĐI			JAPAN
BELVEDERE			AUSTRIJA
DESPIĆA KUĆA			BIH
ZEPION				GRČKA
PENTOMINIUM			DUBAI
BIG BEN				ENGLESKA
KREMLJ				RUSIJA
KRISTALNA PALATA		SLOVENIJA

SPOJITE SPECIJALITETE NACIONALNIH KUHINJA SA GLAVNIM SASTOJKOM
PINĐUR				PLAVI PATLIDŽAN
BORŠČ				PARADAJZ
VURDA				MLEKO
PROJA				KUKURUZNO BRAŠNO
SARMA				KISELI KUPUS
URNEBES				LJUTA PAPRIKA
KAVURMA			IZNUTRICE
RATATUJ				POVRĆE

SPOJITE STADIONE SA SPORTOVIMA KOJI SE NA NJIMA ODRŽAVAJU:
BRYANT-DENNY ALABAMA		AMERIČKI FUDBAL
EDEN GARDENS KOLKATA		KRIKET
TWICKENHAM LONDON		RAGBI
OLYMPIASTADION MUNICH		ATLETIKA
DODGER LOS ANGELES		BEJZBOL
SIMPLE THURLES			HARLING
SINGAPORE NATIONAL KALLANG	FUDBAL
AAMI ADELAIDE			AUSTRALIJSKI FUDBAL

SPOJITE NOVČANICE SA OSOBAMA ČIJI SE LIKOVI NALAZE NA NJIMA
10 RSD				VUK KARADŽIĆ
1 USD				DŽORDŽ VAŠINGTON
5000 RSD				SLOBODAN JOVANOVIĆ
5 USD				ABRAHAM LINKOLN
10 GBP				ČARLS DARVIN
50 RSD				STEVAN MOKRANJAC
20 USD				ENDRJU DŽEKSON
200 RSD				NADEŽDA PETROVIĆ

SPOJITE NAJBOLJE STRELCE SA SVETSKIM PRVENSTVIMA U FUDBALU
SP 1954				ŠANDOR KOČIŠ
SP 1966				EUZEBIO
SP 1970				GERD MILER
SP 1978				MARIO KEMPES
SP 1982				PAOLO ROSI
SP 1986				GERI LINEKER
SP 1990				SALVATORE SKILAČI
SP 1998				DAVOR ŠUKER

POVEŽITE OZNAKE SA VRSTOM NAORUŽANJA KOJEM PRIPADAJU
KA-52				BORBENI HELIKOPTER
S-400				PVO SISTEM
T-90				TENK
RQ-7				BESPILOTNA LETELICA
M-249				PUŠKOMITRALJEZ
SU-35				BORBENI AVION
AN-124				TRANSPORTNI AVION
E-3				AWACS

SPOJITE BROJEVE SA NJIHOVIM NAJMANJIM ZAJEDNIČKIM SADRŽAOCEM
2 I 7				14
3 I 8				24
9 I 6				18
2 I 4				4
4 I 7				28
2 I 11				22
15 I 6				30
18 I 4				36

SPOJITE POZIVNE BROJEVE SA DRŽAVAMA
34				ŠPANIJA
7				RUSIJA
44				ENGLESKA
32				BELGIJA
46				ŠVEDSKA
359				BUGARSKA
39				ITALIJA
420				ČEŠKA

SPOJITE DRŽAVE SA VREMENSKIM ZONAMA KOJIMA PRIPADAJU
GMT MINUS 4			PORTORIKO
GMT PLUS 12			NOVI ZELAND
GMT PLUS 10			PAPUA NOVA GVINEJA
GMT PLUS 9			JAPAN
GMT PLUS 11			NOVA KALEDONIJA
GMT MINUS 3			ARGENTINA
GMT PLUS 8			AUSTRALIJA
GMT MINUS 5			JAMAJKA

SPOJITE MODELE AUTOMOBILA SA GODINOM KADA SU SE POJAVILI NA TRŽIŠTU
FIJAT 500L			2012
JUGO FLORIDA			1988
ZASTAVA 101			1971
ZASTAVA 750 (FIĆA)		1955
GOLF 2				1983
MERCEDES BENC W136		1936
ŠKODA FABIA			1999
VARTBURG 353			1966

SPOJITE BROJEVE SA NJIHOVIM KVADRATNIM KORENOM
169				13
64				8
625				25
289				17
121				11
441				21
81				9
361				19

SPOJITE BORBENE TENKOVE SA ZEMLJOM POREKLA
M60 PATON			SAD
ČIFTEN				VELIKA BRITANIJA
AMH-30				FRANCUSKA
BT-7M				SSSR
TIGAR				NEMAČKA
TIP 59D				KINA
RAMZES II			EGIPAT
M-84				JUGOSLAVIJA

SPOJITE BITKE SA GODINAMA ODRŽAVANJA
1806.				BITKA NA MIŠARU
1804.				ČOKEŠINA
1813.				LAJPCIG
1371.				MARIČKA BITKA
1805.				TRAFALGAR
1809.				ČEGAR
1944.				BITKA ZA NORMANDIJU
1853.				KRIM

SPOJITE NAZIVE PESAMA SA BROJEVIMA KOJI NEDOSTAJU
... U VOLTIMA			220
PATIM, EVO, ... DANA		10
... GODINA			1000
... DINARA, DRUŽE			2
SVETOZARA MARKOVIĆA...		39
JUŽNA AFRIKA...			85
ZAŽMURI BROJ DO ...		100
JOŠ ... ŠUGAV DAN			1

POREĐAJ HRONOLOŠKI ALBUME ''BIJELOG DUGMETA'' (BROJ 1 ZA NAJSTARIJI)
PLJUNI I ZAPJEVAJ, MOJA JUG...	7
BITANGA I PRICEZA		3
KAD BIH BIO BIJELO DUGME	1
DOŽIVJETI STOTU			4
ETO, BAŠ HOĆU			2
BIJELO DUGME			6
ĆIRIBIRIBELA			8
USPAVANKA ZA RADMILU		5

POVEŽITE MINISTRE SA NJIHOVIM MINISTARSTVIMA U VLADI MIRKA CVETKOVIĆA
UNUTRAŠNJI POSLOVI		IVICA DAČIĆ
FINANSIJE			DIJANA DRAGUTINOVIĆ
MINISTARSTVO PRAVDE		SNEŽANA MALOVIĆ
RUDARSTVI I ENERGETIKA		PETAR ŠKUNDRIĆ
ZDRAVLJE			TOMICA MILOSAVLLJEVIĆ
MINISTAR BEZ PORTFELJA		SULEJMAN UGLJANIN
KOSOVO I METOHIJA		GORAN BOGDANOVIĆ
INFRASTRUKTURA			MILUTIN MRKONJIĆ

POVEŽITE SPORTSKE RIVALE
OLIMPIJAKOS			PANATINIKOS
ČELZI				ARSENAL
DINAMO				HAJDUK
SELTIK				RENDŽERS
FEHERBAHČE			GALATASARAJ
LACIO				ROMA
BENFIKA				SPORTING
AJAKS				FEJNORD

POVEŽITE NUMERE CRVENE JABUKE SA ALBUMIMA KOJIM PRIPADAJU
AKO ME PITAŠ KAMARADE		OPROSTI ŠTO JE LJUBAVNA
OTROV				ZA SVE OVE GODINE
NEKA GORE SVJETOVI		SVE ŠTO SANJAM
MOJE NAJMILIJE			NEKAKO S' PROLJEĆA
NOĆI SU HLADNE			DUŠA SARAJEVA
TO MI RADI			TAMO GDJE LJUBAV POČINJE
DA MI JE DO NJE			SVIJET JE LOPTA ŠARENA
ZOVU NAS ULICE			SANJATI